0 5 0 5 0 5 0 5 0 5 0 5 0 5 0 5 0 5 0 5 0 5 0 5 0 5 0 5 0 5 0 5 0 5 0 5 0 5 0 5 0
5 0 5 0 5 0 5 0 5 0 5 0 5 0 5 0 5 0 5 0 5 0 5 0 5 0 5 0 5 0 5 0 5 0 5 0 5 0 5 0 5
0 5 0 5 0 5 0 5 0 5 0 5 0 5 0 5 0 5 0 5 0 5 0 5 0 5 0 5 0 5 0 5 0 5 0 5 0 5 0 5 0
5 0 5 0 5 0 5 0 65 70 5 0 5 0 5 0 5 0 5 0 5 60 75 0 5 0 5 0 5 0 5 0 5 0 5 0 5 0 5 0 5
0 5 0 5 30 45 0 5 110 125 0 5 0 5 0 35 40 5 0 5 0 115 120 5 0 5 0 5 0 5 0 5 0 5 0 5 0 5 0 5 0
5 0 5 0 85 90 5 0 165 170 5 0 5 0 5 80 95 0 5 0 5 160 175 0 5 0 5 0 5 0 5 0 5 0 5 0 5 0 5 0 5
1 1 1 1 1 1 1 1 1 1 1 1 1 1 1 1 1 1 1 1 1 1 1 1 1 1 1 1 1 1 1 1 1 1 1 1 1 1 1 1 1
2 2 2 2 2 2 2 2 2 2 2 2 2 2 2 2 2 2 2 2 2 2 2 2 2 2 2 2 2 2 2 2 2 2 2 2 2 2 2 2 2